R 1080 720
NO textures/redbrick.xpm
SO textures/mossy.xpm
WE textures/stone.xpm
EA textures/wood.xpm
S textures/dog.xpm
F 80,80,80
C 200,255,255




11111111111111111111111111
10001000000000000200000001
10001000000000000000000001
10001000000000000000000001
10001000000000000000000001
100010000000W0000000000001
10000000000000000000000001
10000000000000000000000001
11000000001100000000000011
11111000000000000000111111
10000000000000000000000011
10000011111100000000000001
10000011111100000000000001
10000011111100000020000001
10000011111100000000000001
10000011111120000000000021
10000011111100000000000001
10000011111100000020000001
10000011111100000000000001
10000011111100000002000001
11111111111111111111111111
